0000000000000000000000000000000000000000000000000000000000000000000000000000000000000000000000000000000000000000000000000000000000000000000000000000000000000000000000000000000000000000000000000000000000000000
0000000000000000000000000000000000000000000000000000000000000000000000000000000000000000000000000000000000000000000000000000000000000000000000000000000000000000000000000000000000000000000000000000000000000000
0000000000000000000000000000000000000000000000000000000000000000000000000000000000000000000000000000000000000000000000000000000000000000000000000000000000000000000000000000000000000000000000000000000000000000
0000000000000000000000000000000000000000000000000000000000000000000000000000000000000000000000000000000000000000000000000000000000000000000000000000000000000000000000000000000000000000000000000000000000000000
0000000000000000000000000000000000000000000000000000000000000000000000000000000000000000000000000000000000000000000000000000000000000000000000000000000000000000000000000000000000000000000000000000000000000000
0000000000000000000000000000000000000000000000000000000000000000000000000000000000000000000000000000000000000000000000000000000000000000000000000000000000000000000000000000000000000000000000000000000000000000
0000000000000000000000000000000000000000000000000000000000000000000000000000000000000000000000000000000000000000000000000000000000000000000000000000000000000000000000000000000000000000000000000000000000000000
0000000000000000000000000000000000000000000000000000000000000000000000000000000000000000000000000000000000000000000000000000000000000000000000000000000000000000000000000000000000000000000000000000000000000000
0000000000000000000000000000000000000000000000000000000000000000000000000000000000000044400000000000000000000000000000000000000000000000000000000000000000000000000000000000000000000000000000000000000000000000
0000000000000000000000000000000000000000000000000000000000000000000000000000000000000001000000000000000000000000000000000000000000000000000000000000000000000000000000000000000000000000000000000000000000000000
0000000000000000000000000000000000000000000000000000000000000000000000000000000000100000000000000000000000000000000000000000000000000000000000000000000000000000000000000000000000000000000000000000000000000000
0000000000000000000000000000000000000000002000000000000000000000000000000000001000003000000000000000000000000000000000000000000000000000000000000000000000000000000000000000000000000000000000000000000000000000
0000000000000000000000000000000000000001111110000000000000000000000000000010000000000010000000000000000000000000000000000000000000000000000000000000000000000000000000000000000000000000000000000000000000000110
0000000000000000000000000000000000001111000000000000000000000000000000010000000000000000000000000000000000000000000000000000000000000000000000000000000000000000000000000000000000000000000000000000000000000410
1100000000000000000000000000000000000000000000000000000000000000000000220000000000000000000000000000000000000000000000000000000000400400000000000000000000000000000000000000000000000000000000000000000000000010
1111111111111111111000111110001111111111112221111000000000000001111111110000000000000000000001111111110000111000111111111111111110010001111110000000000000000000000000000000000000000001111111111111111111110010
1111111113113111111000011100001111111111111111111000000000110000111111111000111000111110011000000000100011110000111110000000000000110001000000000000000111110000000000000000000000000001111111111111111111110110
1111111011111101111000001000001111111111111111111000111110011000000000000001110000111110013000010000000011110000111110000000000000110001000000000000000000010000000000000000011111111001111111111111111111110110
1111111100000011111000001000001111111111111111111000222220011111111111111111110000111110011111111111111111110000111110000000000001110001000000000000000010010000000000221110011111110001111111111111111111110110
1111111112002111111000000000001111111111111111111000111110011111111111111111110000111110011111111111111111110001111110000000000001113000000000000000000210110000001111111110010111100001000000000000111111110110
1111111111111111111000000000001111111111111111111000111110011111111111111111110000111110011111111111111111110000000000000000100030000000000000000001111113000011100000000000010000000030000000000100111111110110
1111111111111111111000000000001111111111111111111000111110011111111111111111110000111110011111111111111111110000001000001000000111111111111111110000000011111001000000000000000000000000000000000101111111110110
1111111111111111111000000000001111111111111111111000111110011111111111111111110000111110011111111111111111110111111010000000000000000000000000000000000010000001000000000000000001100000000011111101111111110110
1111111111111111111000000000001111111111111111111000111110011111111111111111110000111110011111111111111111110000111112222222222222222222222222222222222212222221222222222222112222222111112211111101111111110100
1111111111111111111000000000001111111111111111111000111110011111111111111111112222111112211111111111111111112222111111111111111111111111111111111111111111111111111111111111111111111111111111111101111111110000
1111111111111111111111111111111111111111111111111111111111111111111111111111111111111111111111111111111111111111111111111111111111111111111111111111111111111111111111111111111111111111111111111100000000000050
1111111111111111111111111111111111111111111111111111111111111111111111111111111111111111111111111111111111111111111111111111111111111111111111111111111111111111111111111111111111111111111111111111111111111111